....................
....................
....................
...##..##...........
....................
####################
