...........#
...........#
..#........#
...........#
#....#.o..$#
############
